scenes_stereo/supermarket09.wav	supermarket
scenes_stereo/tubestation10.wav	tubestation
scenes_stereo/quietstreet08.wav	quietstreet
scenes_stereo/office10.wav	office
scenes_stereo/bus01.wav	bus
scenes_stereo/restaurant05.wav	restaurant
scenes_stereo/busystreet05.wav	busystreet
scenes_stereo/openairmarket04.wav	openairmarket
scenes_stereo/quietstreet01.wav	quietstreet
scenes_stereo/supermarket05.wav	supermarket
scenes_stereo/openairmarket01.wav	openairmarket
scenes_stereo/office07.wav	office
scenes_stereo/tube07.wav	tube
scenes_stereo/tubestation05.wav	tubestation
scenes_stereo/tubestation07.wav	tubestation
scenes_stereo/supermarket02.wav	supermarket
scenes_stereo/busystreet08.wav	busystreet
scenes_stereo/bus04.wav	bus
scenes_stereo/park04.wav	park
scenes_stereo/park09.wav	park
scenes_stereo/busystreet07.wav	busystreet
scenes_stereo/restaurant01.wav	restaurant
scenes_stereo/bus06.wav	bus
scenes_stereo/tube01.wav	tube
scenes_stereo/restaurant10.wav	restaurant
scenes_stereo/tube03.wav	tube
scenes_stereo/office08.wav	office
scenes_stereo/quietstreet05.wav	quietstreet
scenes_stereo/park10.wav	park
scenes_stereo/openairmarket05.wav	openairmarket
